WWWWWWWWWWWWWWWWWWWW
W           W      W
W   1       W    F W
WWWWWW             W
W                  W
W      WWWWWW    2 W
W           W      W
W         F W      W
W           W      W
W                  W
W 3                W
WWWWWWWWWW         W
W                  W
W                4 W
W       WWWWW      W
W           W      W
W         F W    WWW
W           W      W
W           W    F W
WWWWWWWWWWWWWWWWWWWW